"filename", "language", "C++", "JSON", "comment", "blank", "total"
"d:\program\cpp_program\SoftRenderer_v2.0\Build\.cmake\api\v1\reply\index-2024-05-27T05-55-27-0652.json", "JSON", 0, -132, 0, -1, -133
"d:\program\cpp_program\SoftRenderer_v2.0\Build\.cmake\api\v1\reply\index-2024-06-05T08-49-25-0170.json", "JSON", 0, 132, 0, 1, 133
"d:\program\cpp_program\SoftRenderer_v2.0\include\gameobject\Camera.hpp", "C++", 10, 0, -17, 1, -6
"d:\program\cpp_program\SoftRenderer_v2.0\include\math\MinHeap.hpp", "C++", 1, 0, 0, 0, 1
"d:\program\cpp_program\SoftRenderer_v2.0\include\math\OcTree.hpp", "C++", 107, 0, 0, 16, 123
"d:\program\cpp_program\SoftRenderer_v2.0\include\math\Vector.hpp", "C++", 11, 0, 0, 1, 12
"d:\program\cpp_program\SoftRenderer_v2.0\include\pipeline\RenderPipeline.hpp", "C++", 2, 0, 0, 0, 2
"d:\program\cpp_program\SoftRenderer_v2.0\src\component\Mesh.cpp", "C++", 48, 0, 7, 10, 65
"d:\program\cpp_program\SoftRenderer_v2.0\src\gameobject\Camera.cpp", "C++", -1, 0, 12, 1, 12
"d:\program\cpp_program\SoftRenderer_v2.0\src\math\MinHeap.cpp", "C++", 15, 0, 0, 3, 18
"d:\program\cpp_program\SoftRenderer_v2.0\src\pipeline\RenderPipeline.cpp", "C++", 43, 0, 3, 14, 60
"Total", "-", 236, 0, 5, 46, 287